##############
#*........~.1#
#.........~..#
#.........~~~#
#............#
#............#
#............#
#............#
#.&........D.#
##############

?1/
?D|

=1D
@1T
@D16
