########################
#.............#........#
#.............#*......1#
#.............$$$$$$$$$#
#......................#
#......................#
#............###########
#.........#............#
#.&...#..............D.#
####................####
####.........C......####
####........AB......####
########################

?1/
?A_
?B_
?C_
?D|

=1A
=1B
=1C
=1D

@1T
@A (9,0)
@B (9,0)
@C (9,0)
@D11
