#########################
#.............#...-.....#
#.............#...-..1..#
#...&.........A...-.....#
#.2.D.............-.....#
#########################

?1/
?2/
?D|
?A_

=2A
=1D
@D13
@A (0,-2)
@2T