#################
#.......$*$...#1#
#.......$.$.$.#.#
#.D..&..$...$...#
#################

?D|
?1/

=1D
@1T
@D18
