........$$..................................
..##........##......######################..
....................##.................#....
.....##.......$$$...##..$$$..$$$..$$$..#....
...*...............*.............*..........
.........#$#................................
.........#$#...............................#
####################..######################
