0000000000
0011000000
0000000000
0000011000
0000000000
0000000001
0000000001
1111111111