###############################
#.............................#
#.............................#
#.............................#
#.............................#
#.............................#
#.............................#
#########....................D#
........#.........#############
........#.........#............
........###########............

?D|