......#######...
......#..$.1#...
#######...##.###
#...............#
#...............#
#.......#......|#
#############.###

?1/
