......#######...
......#..$.1#...
#######...#######
#...............#
#...............#
#.......#.......#
#################
