00000000220000000000000000000000000000000000
00110000000011000000111111111111111111111100
00000000000000000000110000000000000000010000
00000110000000222000110022200222002220010000
00000000000000000000000000000000000000000000
00000000012100000000000000000000000000000000
00000000012100000000000000000000000000000001
11111111111111111111001111111111111111111111
