###############################
#.............................#
#.............................#
#.............................#
#.............................#
#.................~...........#
#.................~...........#
#########.........~~.........|#
........#.........#############
........#.........#............
........###########............
