###############################
#.............................#
#.............................#
#.............................#
#.............................#
#................#............#
#&........#......#........D...#
###############################

?D|
