###############################
#.............................#
#.............................#
#.............................#
#.............................#
#................#............#
#.........#......#........D...#
###############################

?D|
