##################
#................#
#..............1.#
#................#
#.&..D...F.......#
##################

?1/
?D|
?F@

=1D
=1F
