###############################
#.............................#
#.............................#
#.............................#
#.............................#
#.................~...........#
#&................~...........#
#########.........~~.........D#
........#.........#############
........#.........#............
........###########............

?D|