###################################
#.................................#
#.................................#
#.................................#
#...............................D.#
#...............##.FH..........####
#&.ABG.........................####
###............................####
###............................####
###################################

?D|
?A_
?B_
?G_
?F_
?H_

@A MLR (9,0)~(5,-3)
@B MLR (9,0)~(5,-3)
@G MLR (9,0)~(5,-3)
@F MLR (9,0)~(5,-3)
@H MLR (9,0)~(5,-3)

@D05
