......#######...
......#..$..#...
#######..$###.###
#...............#
#...............#
#...............#
#############.###
