#################
#...............#
#...............#
#...............#
#...............#
#.&...........D.#
######~~~~~~~####
#...............#
#..........#....#
#...............#
#.....#.........#
#...............#
#.........#.....#
#...............#
#..............##
#.1.#.....*.....#
#...#....###....#
#####...........#
#################

?1/
?D|

=1D
