##################
#................#
#..............1.#
#........F.......#
#.&..D...........#
##################

?1/
?D|
?F@

=1D
=1F

@D08