###############################################
#      ..                    .-...+...-...+...#
#      ..    A         B     .-...+...-...+...#
#      ...                    -...+...-...+...#
#     &.                     .-...+...-...+.D.#
#    #####-------###+++++++####################
###               -        #
###               -        #
 ###########################


?D|
?A!
?B!

@D15
@A14a
@B14b
