##################
#................#
#..............1.#
#................#
#.&..D...........#
##################

?1/
?D|

=1D
@D03
