#################
#....H...$.1#####
#........########
#...........M...#
#...........N...#
#.&...#.....O.D.#
#################

?1/
?D|
?M_
?N_
?O_
?H!

=1D
=1M
=1N
=1O

@M (0,-3)
@N (0,-3)
@O (0,-3)

@H03a

@D04
