###############################
#.............................#
#.............................#
#.............................#
#.............................#
#.............................#
#.............................#
#########.....................#
........#.........#############
........#.........#............
........###########............
