##################
#................#
#......H.......1.#
#................#
#.&..D...........#
##################

?1/
?D|
?H!

=1D
@D03
@H02a
