#################################
#############...2.......3....####
###...1######................####
###..####ABC.................E###
#...............................#
#&.............................D#
#############################F###

?1/
?2/
?3/
?D|
?A_
?B_
?C_
?E_
?F_

=1A
=1B
=1C
=2E
=2F
=3E
=3F

@A (17,0)
@B (17,0)
@C (17,0)
@E (0, 1)
@F (0, -1)

@D08
