00000001
00000001
00001001
00001001
00000001
00000001
00000001
00010001
00010001
00000111