                    ###############
#################### $*.......$.1.#
#                #####$$$$$$$$#####
#.......H........#                #
#................#                #
#................                 #
#................                 #
#.&.............          D       #
##########$$$$$####################
         #     #
         #  *  #
         ####### 
?1/
?D|
?H!

=1D
@D06
@H05a
