#####################
#...-...+...-...+...#
#...-...+...-...+...#
#.&.-...+...-...+.D.#
#####################

?D|

@D17
