################
#..............#
#..............#
#..............#
#........#.....#
#.............|#
#######......###
#..............#
#..........#...#
#..............##
#.....#..........#
#................#
.#.........#.....#
.#...............#
.#..............##
.#1###....*......#
.#####...####....#
.#...............#
.#################

?1/
