......#######...
......#..$..#...
#######...#######
#...............#
#...............#
#.......#.......#
#################
