###############################
#.............................#
#.............................#
#.............................#
#.............................#
#.............................#
#.............................#
#########....................|#
........#.........#############
........#.........#............
........###########............
