#################
#...............#
#...............#
#...............#
#...............#
#.&...........D.#
######.......####
#...............#
#.........##....#
#.*.............#
#....##.........#
#...............#
#........##.....#
#....H..........#
#.............###
#.1.#...........#
#...#....###....#
#####...........#
#################

?1/
?D|
?H!

=1D
@1T
@D09
@H05a