......#######...
......#..$..#...
#######...##.###
#...............#
#...............#
#.......#......|#
#############.###
