00000001
00000001
01000001
01000001
00000001
00000001
00010001
00010001
00000001
00000111