######################################
#.................&..................#
#....................................#
#....................................#
#....................................#
#...........------...............S...#
#.~~~~~~.................++++........#
#.~....~....~~~.........+............#
#.~....~....~~~.........+........D...#
#################-----################



?D|
?S/

=SD

@ST
