#############
#...........#
#...........#
#.......#...#
#.....++#+++#
#.......#---#
#--.....#+++#
#.......#---#
#.....++#+++#
#.......#---#
#--.....#+++#
#...&...#---#
#########+++#
........#...#
........#...#
........#.D.#
........#####

?D|

@D17
