#############
#...........#
#...........#
#.......#...#
#.....++#+++#####
#.......#---#   #  
#--.....#+++# 1 #  
#.......#---#   #  
#.....++#+++#   #  
#.......#---#   #  
#--.....#+++#   #  
#...&...#---#   #  
#########+++#~ ~#  
....#.2.#...#   #######
....#...C...      A   #
....#...E  .      B D #
....#...#####-----#####
    ##            # 
    ##            #
    ###############

?1/
?2/
?A_
?B_
?C_
?E_
?D|

=1A
=1B
=2C
=2E
=21

@A (0,-1)
@B (0,1)
@C (0,-1)
@E (0,1)

@D17
