......#######...
......#..$..#...
#######...##.###
#...............#
#...............#
#.......#.......#
#############.###
