........$$..................................
..##........##......######################..
...............................$............
....................##.................#....
.....##.......$$$...##..$$$..$$$..$$$..#....
............................................
............................................
.........###...............................#
####################..######################
