00000000002000
00110000022200
00000000000000
00000110000000
00000000002000
00000000012100
00000000012100
11111111111111