###############################################
#      ..                    .-...+...-...+...#
#      ..                    .-...+...-...+...#
#      ...                    -...+...-...+...#
#     &.                     .-...+...-...+.D.#
#    ######------###+++++++####################
###               -        #
###               -        #
 ###########################


?D|

@D15
