######################################
#.................&..................#
#........... .........###............#
#................*...........#.......#
#....###.....................#.......#
#............................#.......#
######################################




