######################################
#.................&..................#
#....................................#
#....................................#
#.....A..............................#
#.....B......................S.......#
#....................................#
#....................................#
#............................D.......#
######################################


?A_
?B_
?D|
?S/

=SD

@A ML (10,0)(10,5)(0,0)
@B MLR (10,0)(20,0) ~ (5,-5)(15,5)
@ST