#################################
#4###########...2.......3....####
#.#....1#####................####
#.#..####ABCG................E###
#...............................#
#&.............................D#
#############################F###

?1/
?2/
?3/
?4/  # reset switch for the level
?D|
?A_
?B_
?C_
?E_
?F_
?G_

=1A
=1B
=1C
=1G
=2E
=2F
=3E
=3F
=41
=42
=43

@A (16,0)
@B (16,0)
@C (16,0)
@G (16,0)
@E (0, 1)
@F (0, -1)

@D08
@4T
