......########...
......#..$...#...
#######...#######
#...............#
#...............#
#.......#.......#
#################