............................................
..##........##......######################..
....................##.................#....
.....##.......$$$...##.................#....
............................................
.........#$#................................
.........#$#...............................#
####################..######################
