################################
#....................#3........#
#....................#.........#
#.....&..............A...~.....#
#.D.........2........B...~..1..#
################################

?1/
?2/
?3/
?D|
?A_
?B_


=3A
=3B
=2A
=2B
=1D
@D13
@A (0,-2)
@B (0,-2)
@2T
@3T